11111111111
11111111110
01111111110
00111111100
00111111100